NO ./path_to_t he_north_texture
SO ./path_to_the_south_texture
WE ./path_to_the_west_texture
EA ./path_to_the_east_texture

F 220,100,0
C 225,30,0

        1111111111111111111111111
        1000000000110000000000001
        10110N0011100000000000001
        1001001000000000010000001
111111111011000101110000001000001
100000000011000001110111111111111
11110111111111011100000010001
11110111111111011101010010001
11000000110101011100000010001
10000000000000001100000000001
100000000000000011010100100011
1100000111010101110010110010001
11110111 1110101 10111101000111
11111111 1111111 11111111111