NO    ./textures/wall_no.xpm
SO    ./textures/wall_so.xpm
WE    ./textures/wall_we.xpm
EA    ./textures/wall_ea.xpm

C 135,206,235
F 234,221,202


        11111111111111111111111111
        1000000000110000000000001
        10110000011100000000000W1
        1001001000000000010000001
111111111011000101110000001000001
100000000011000001110111111111111
11110111111111011100000010001
11110111111111011101010010001
11000000110101011100000010001
10000000000000001100000000001
100000000000000011010100100011
1100000111010101110010110010001
11110111 1110101 10111101000111
11111111 1111111 1111111111111