NO ./textures/wall_no.xpm
SO ./textures/wall_so.xpm
WE ./textures/wall_we.xpm
EA ./textures/wall_ea.xpm

C 135,206,235
F 234,221,202

111111111111
100000000001
100000010001
100000N01001
100000000001
111111111111