NO    ./textures/wall_no.xpm
 SO    ./textures/wall_so.xpm
       WE    ./textures/wall_we.xpm
EA    ./textures/wall_ea.xpm
C 135,206,235
F 234,221,202

11111111111111111111111111
11111110000000000001111111
11111110001000100001111111
11111110001000100001111111
111111100010S0100001111111
11111110001000100001111111
11111110001000100001111111
11111000000000000000011111
11111111111111111111111111
11111111111111111111111111